11111111111111111111
1P0000000C00000000E1
11111111111111111111