111111
100001
111111
1P1001
10E001
111111