11111111111111111111111111111111111111111111111111
100000000000000000000000000000000000000000000000C1
10000000000000000000000000000000C00000000000000001
10000000000000000000000000000000000000000000000001
1000000000000C000000000000000000000000000000000001
10000000000000000000000000000000000000000000000001
10000000000000000000000000000000000000000000000001
10000000000000000000000000000000000000000000000001
10000000000000000000000000000000000000000000000001
10000000000000000000000000000000000000000E00000001
10000000000000000000000000000000000000000000000001
10000000000000000000000000000000000000000000000001
10000000000000000000000000000000000000000000000001
1000000000000000C000000000000000000000000000000001
10000000000000000000000000000000000000000000000001
10000000C0000000000000000000000C000000000000000001
10000000000000000000000000000000000000000000000001
100000000000000000000000000000000000000C0000000001
10000000000000000000000000000000000000000000000001
10000000000000000000000000000000000000000000000001
10000000000000000000000000000000000000000000000001
10000000000000000000000000000000000000000000000001
10000000000000000000000000000000000000000000000001
100000000000000000000000C0000000000000000000000001
10000000000000000000000000000000000000000000000001
1000000000000000000000000000000000000C000000000001
10000000P00000000000000000000000000000000000000001
10000000000000000000000000000000000000000000000001
10000000000000000000000000000000000000000000000001
10000000000000000000000000000000000000000000000001
100000000000000000000000000000C0000000000000000001
10000000000000000000000000000000000000000000000001
11111111111111111111111111111111111111111111111111