111111111111111111
10000C000CCC100001
1000C0E0C000C01001
100C0C000000C10011
10C00C00000C100001
10CCCC0000C1000001
1000PC000C10000001
10000C00CCCCCC0001
111111111111111111