1111111
1000001
11001P1
1E01C11
1111111